08 08 05
XXXXXXXX
XX.XX..X
X.JMJJ.X
XGX....X
XGXJXX.X
X...JG.X
X..G..GX
XXXXXXXX
