08 08 01
XXXXXXXX
XXX.XXXX
X.JMXXXX
XXX.XXXX
XXXXXXXX
XXXXXXXX
XXXXXXXX
XXXXXXXX
