08 08 01
XXXXXXXX
XXX.XXXX
XXXJXXXX
XX.M.XXX
XXX.XXXX
XXXXXXXX
XXXXXXXX
XXXXXXXX
