08 08 01
XXXXXXXX
XXXXXXXX
XXXXXXXX
XXXXXXXX
XGJM.JGX
XX.J.XXX
XX.G.XXX
XXXXXXXX
