12 07 05
XXXXXXXXXXXX
XXXX....G..X
XX.J.XXGGG.X
XMJ.J....G.X
X.JJ....X..X
X......XX..X
XXXXXXXXXXXX
